###############################
# .............               #
# ############# ###############
#                             #
#   #### #############        #
#      # #                    #
#      # #############        #
#                             #
###############################